111111111111111111111
1P0X0C000C000E011C001
100111000010000000001
10X00C0X0X11100111101
10000C000010000100001
100X0X0000X000010X001
1001110X0011111100001
100000000C00C00001CC1
100111100X00000100001
101001C1001110010X001
101X01011010000000001
101001011010E00X00XC1
10000CC1CC00000000001
111111111111111111111
