111111111
100C00C01
10P000001
10C000E01
1C00E0001
111111111
