11111111111
1C110C00011
10110001011
10110X01C11
10110001111
10000000001
1C0X0P0X0E1
10000000001
11110X01101
10C10001101
10110E01101
10111111101
1C000000001
11111111111
