1111111111111
10C00000000C1
1000P0C0C1111
1X0000X0000E1
1111111111111
